{
    "map": [[1,1,1,1,1,1,1,1,1,1,1,1,1,1,1,1,1,1,1,1,1,1,1,1],
            [1,0,0,0,0,0,0,0,0,1,0,0,0,0,0,0,0,0,0,0,0,0,0,1],
            [1,0,0,0,0,0,0,0,0,1,0,0,0,0,0,0,0,0,0,0,0,0,0,1],
            [1,0,0,0,0,0,0,0,0,1,0,0,0,0,0,0,0,0,0,0,0,0,0,1],
            [1,0,0,0,0,0,0,0,0,1,0,0,0,0,1,0,0,0,0,0,0,0,0,1],
            [1,0,0,0,0,0,0,0,0,1,0,0,0,0,1,0,0,0,0,0,0,0,0,1],
            [1,0,0,0,0,0,0,0,0,2,0,0,0,0,2,0,0,0,0,0,0,0,0,1],
            [1,0,0,0,0,1,1,1,2,2,0,0,0,0,2,2,1,1,1,1,1,1,1,1],
            [1,0,0,0,0,0,0,0,0,0,0,0,0,0,0,0,0,0,0,0,0,0,0,1],
            [1,0,0,0,0,0,0,0,0,0,0,0,0,0,0,0,0,0,0,0,0,0,0,1],
            [1,0,0,0,0,0,0,0,0,0,0,0,0,0,0,0,0,0,0,0,0,0,0,1],
            [1,1,1,1,1,1,1,1,2,2,0,0,0,0,2,2,1,1,1,0,0,0,0,1],
            [1,0,0,0,0,0,0,0,0,2,0,0,0,0,2,0,0,0,0,0,0,0,0,1],
            [1,0,0,0,0,0,0,0,0,1,0,0,0,0,1,0,0,0,0,0,0,0,0,1],
            [1,0,0,0,0,0,0,0,0,1,0,0,0,0,1,0,0,0,0,0,0,0,0,1],
            [1,0,0,0,0,0,0,0,0,0,0,0,0,0,1,0,0,0,0,0,0,0,0,1],
            [1,0,0,0,0,0,0,0,0,0,0,0,0,0,1,0,0,0,0,0,0,0,0,1],
            [1,0,0,0,0,0,0,0,0,0,0,0,0,0,1,0,0,0,0,0,0,0,0,1],
            [1,1,1,1,1,1,1,1,1,1,1,1,1,1,1,1,1,1,1,1,1,1,1,1]],
    "player": {
        "position": { "x": 5, "y": 12},
        "velocity": { "x": 0, "y": 0},
        "turretDirection": { "x": 1, "y": 0.5}
    },
    "enemyTanks": [
        {
            "type": "BrownTurret",
            "position": { "x": 41, "y": 5},
            "velocity": { "x": 0, "y": 0},
            "turretDirection": { "x": 1, "y": 0.5}
        },
        {
            "type": "BrownTurret",
            "position": { "x": 31, "y": 5},
            "velocity": { "x": 0, "y": 0},
            "turretDirection": { "x": 1, "y": 0.5}
        },
        {
            "type": "GreySoldier",
            "position": { "x": 10, "y": 27},
            "velocity": { "x": 1, "y": 1},
            "turretDirection": { "x": 0, "y": -1}
        },
        {
            "type": "TealHunter",
            "position": { "x": 40, "y": 27},
            "velocity": { "x": 0, "y": 1},
            "turretDirection": { "x": 1, "y": 0.5}
        }
    ]
}
