{
    "map": [[1,1,1,1,1,1,1,1,1,1,1,1,1,1,1,1,1,1],
          [1,0,0,0,0,0,0,0,0,0,0,0,0,0,0,0,0,1],
          [1,0,0,0,0,0,0,0,0,0,0,0,0,0,0,0,0,1],
          [1,0,0,0,0,0,0,0,0,0,0,0,0,0,0,0,0,1],
          [1,0,0,0,0,1,0,0,0,1,0,0,0,0,0,0,0,1],
          [1,0,0,0,0,1,0,0,0,1,0,0,0,0,0,0,0,1],
          [1,0,0,0,0,1,0,0,0,1,0,0,0,0,0,0,0,1],
          [1,0,0,0,0,1,0,0,0,1,0,0,0,0,0,0,0,1],
          [1,0,0,0,0,1,0,0,0,1,0,0,0,0,0,0,0,1],
          [1,0,0,0,0,1,0,0,0,1,0,0,0,0,0,0,0,1],
          [1,0,0,0,0,0,0,0,0,0,0,0,0,0,0,0,0,1],
          [1,0,0,0,0,0,0,0,0,0,0,0,0,0,0,0,0,1],
          [1,0,0,0,0,0,0,0,0,0,0,0,0,0,0,0,0,1],
          [1,1,1,1,1,1,1,1,1,1,1,1,1,1,1,1,1,1],
          [1,1,1,1,1,1,1,1,1,1,1,1,1,1,1,1,1,1],
          [1,1,1,1,1,1,1,1,1,1,1,1,1,1,1,1,1,1],
          [1,1,1,1,1,1,1,1,1,1,1,1,1,1,1,1,1,1],
          [1,1,1,1,1,1,1,1,1,1,1,1,1,1,1,1,1,1],
          [1,1,1,1,1,1,1,1,1,1,1,1,1,1,1,1,1,1]],
    "player": {
        "position": { "x": 5, "y": 14},
        "velocity": { "x": 0, "y": 0},
        "turretDirection": { "x": 1, "y": 0}
    },
    "enemyTanks": [
        {
            "type": "BrownTurret",
            "position": { "x": 13, "y": 4},
            "velocity": { "x": 0, "y": 0},
            "turretDirection": { "x": -1, "y": 0}
        }
    ]
}
